//MAP CONVERTED BY dmm2tgm.py THIS HEADER COMMENT PREVENTS RECONVERSION, DO NOT REMOVE
"a" = (
/turf/open/floor/rogue/blocks/stonered/tiny,
/area/rogue/under/town/caverogue)
"b" = (
/mob/living/carbon/human/species/zizombie/npc/ambush,
/turf/open/floor/rogue/blocks/stonered/tiny,
/area/rogue/under/town/caverogue)
"c" = (
/obj/structure/fermenting_barrel/beer,
/obj/item/reagent_containers/glass/cup/skull,
/turf/open/floor/rogue/blocks/stonered,
/area/rogue/under/town/caverogue)
"d" = (
/obj/item/clothing/ring/silver/noc,
/turf/open/floor/rogue/blocks/stonered,
/area/rogue/under/town/caverogue)
"e" = (
/obj/effect/landmark/chest_or_mimic,
/obj/item/roguecoin/gold/pile,
/turf/open/floor/rogue/blocks/stonered/tiny,
/area/rogue/under/town/caverogue)
"f" = (
/mob/living/simple_animal/hostile/retaliate/rogue/bigrat,
/obj/item/roguecoin/silver/pile,
/obj/structure/closet/crate/chest,
/turf/open/floor/rogue/blocks/stonered/tiny,
/area/rogue/under/town/caverogue)
"g" = (
/obj/structure/closet/crate/chest,
/obj/item/roguecoin/copper/pile,
/turf/open/floor/rogue/blocks/stonered/tiny,
/area/rogue/under/town/caverogue)
"h" = (
/mob/living/carbon/human/species/zizombie/npc/militiamen,
/turf/open/floor/rogue/blocks/stonered/tiny,
/area/rogue/under/town/caverogue)
"i" = (
/obj/item/roguecoin/copper/pile,
/obj/structure/closet/crate/chest,
/turf/open/floor/rogue/blocks/stonered/tiny,
/area/rogue/under/town/caverogue)
"j" = (
/obj/item/roguestatue/gold,
/turf/open/floor/rogue/blocks/stonered,
/area/rogue/under/town/caverogue)
"k" = (
/mob/living/carbon/human/species/zizombie/npc/peasant,
/turf/open/floor/rogue/blocks/stonered/tiny,
/area/rogue/under/town/caverogue)
"l" = (
/turf/open/floor/rogue/blocks/stonered,
/area/rogue/under/town/caverogue)
"m" = (
/obj/structure/spider/stickyweb,
/turf/open/floor/rogue/blocks/stonered/tiny,
/area/rogue/under/town/caverogue)
"n" = (
/mob/living/simple_animal/hostile/retaliate/rogue/bigrat,
/turf/open/floor/rogue/blocks/stonered/tiny,
/area/rogue/under/town/caverogue)
"o" = (
/obj/structure/rack/rogue/shelf/biggest,
/obj/item/rogueweapon/mace/goden/steel/warhammer,
/obj/item/clothing/head/roguetown/helmet/horned,
/obj/item/clothing/ring/gold/ravox,
/turf/open/floor/rogue/blocks/stonered,
/area/rogue/under/town/caverogue)
"p" = (
/obj/structure/table/vtable,
/obj/item/quiver/arrows,
/obj/item/ammo_casing/caseless/rogue/arrow/poison,
/obj/item/ammo_casing/caseless/rogue/arrow/poison,
/obj/item/ammo_casing/caseless/rogue/arrow/poison,
/turf/open/floor/rogue/blocks/stonered/tiny,
/area/rogue/under/town/caverogue)
"q" = (
/obj/machinery/light/rogue/firebowl,
/turf/open/floor/rogue/blocks/stonered,
/area/rogue/under/town/caverogue)
"r" = (
/mob/living/carbon/human/species/zizombie/npc/warrior,
/turf/open/floor/rogue/blocks/stonered/tiny,
/area/rogue/under/town/caverogue)
"t" = (
/mob/living/simple_animal/hostile/rogue/orc,
/turf/open/floor/rogue/blocks/stonered,
/area/rogue/under/town/caverogue)
"u" = (
/obj/structure/table/vtable/v2,
/obj/item/reagent_containers/glass/bottle/rogue/healthpot,
/obj/item/roguecoin/copper/pile,
/obj/item/roguecoin/copper/pile,
/turf/open/floor/rogue/blocks/stonered/tiny,
/area/rogue/under/town/caverogue)
"v" = (
/mob/living/simple_animal/hostile/retaliate/rogue/spider,
/turf/open/floor/rogue/blocks/stonered/tiny,
/area/rogue/under/town/caverogue)
"w" = (
/obj/item/roguecoin/gold/pile,
/obj/structure/closet/crate/chest/gold,
/turf/open/floor/rogue/blocks/stonered,
/area/rogue/under/town/caverogue)
"x" = (
/obj/structure/table/vtable/v2,
/obj/item/natural/bundle/cloth,
/obj/item/natural/bundle/cloth,
/obj/item/natural/bundle/fibers/full,
/obj/item/natural/bundle/fibers/full,
/obj/item/needle,
/obj/item/needle,
/turf/open/floor/rogue/blocks/stonered/tiny,
/area/rogue/under/town/caverogue)
"y" = (
/obj/structure/mineral_door/wood/donjon/stone,
/turf/open/floor/rogue/blocks/stonered/tiny,
/area/rogue/under/town/caverogue)
"z" = (
/obj/structure/table/vtable,
/obj/item/clothing/suit/roguetown/armor/leather/hide,
/obj/item/clothing/suit/roguetown/armor/leather/hide,
/obj/item/reagent_containers/food/snacks/rogue/friedrat/plated,
/turf/open/floor/rogue/blocks/stonered/tiny,
/area/rogue/under/town/caverogue)
"A" = (
/obj/structure/closet/crate/chest,
/obj/item/roguecoin/gold/pile,
/turf/open/floor/rogue/blocks/stonered/tiny,
/area/rogue/under/town/caverogue)
"B" = (
/obj/machinery/light/rogue/torchholder/r,
/turf/open/floor/rogue/blocks/stonered,
/area/rogue/under/town/caverogue)
"C" = (
/obj/structure/table/wood/nice/decorated,
/obj/item/reagent_containers/food/snacks/rogue/cheddar/aged,
/obj/item/reagent_containers/food/snacks/rogue/cheddarwedge/aged,
/turf/open/floor/rogue/blocks/stonered,
/area/rogue/under/town/caverogue)
"D" = (
/obj/structure/table/wood/nice/decorated,
/obj/item/clothing/ring/gold/protection,
/obj/item/roguestatue/gold/loot,
/obj/item/storage/belt/rogue/leather/plaquegold,
/turf/open/floor/rogue/blocks/stonered,
/area/rogue/under/town/caverogue)
"E" = (
/obj/item/roguecoin/silver/pile,
/obj/structure/closet/crate/chest,
/turf/open/floor/rogue/blocks/stonered/tiny,
/area/rogue/under/town/caverogue)
"F" = (
/mob/living/simple_animal/hostile/retaliate/rogue/spider,
/obj/structure/spider/stickyweb,
/turf/open/floor/rogue/blocks/stonered/tiny,
/area/rogue/under/town/caverogue)
"G" = (
/mob/living/simple_animal/hostile/retaliate/rogue/bigrat,
/obj/item/roguecoin/copper/pile,
/obj/structure/closet/crate/chest,
/turf/open/floor/rogue/blocks/stonered/tiny,
/area/rogue/under/town/caverogue)
"H" = (
/obj/structure/closet/crate/chest,
/obj/item/roguecoin/silver/pile,
/turf/open/floor/rogue/blocks/stonered/tiny,
/area/rogue/under/town/caverogue)
"I" = (
/obj/machinery/light/rogue/torchholder/l,
/obj/structure/fermenting_barrel/beer,
/turf/open/floor/rogue/blocks/stonered,
/area/rogue/under/town/caverogue)
"J" = (
/obj/structure/bed/rogue/hay,
/turf/open/floor/rogue/blocks/stonered,
/area/rogue/under/town/caverogue)
"K" = (
/obj/effect/landmark/chest_or_mimic,
/obj/item/roguecoin/silver/pile,
/turf/open/floor/rogue/blocks/stonered/tiny,
/area/rogue/under/town/caverogue)
"M" = (
/mob/living/simple_animal/hostile/rogue/orc/ranged,
/turf/open/floor/rogue/blocks/stonered,
/area/rogue/under/town/caverogue)
"N" = (
/turf/closed/mineral/rogue/bedrock,
/area/rogue/under/town/caverogue)
"O" = (
/obj/effect/landmark/chest_or_mimic,
/obj/item/roguecoin/copper/pile,
/turf/open/floor/rogue/blocks/stonered/tiny,
/area/rogue/under/town/caverogue)
"P" = (
/turf/closed/wall/mineral/rogue/decostone/fluffstone/reddish,
/area/rogue/under/town/caverogue)
"Q" = (
/obj/machinery/light/rogue/campfire/longlived,
/turf/open/floor/rogue/blocks/stonered/tiny,
/area/rogue/under/town/caverogue)
"R" = (
/obj/machinery/light/rogue/torchholder/l,
/turf/open/floor/rogue/blocks/stonered,
/area/rogue/under/town/caverogue)
"S" = (
/mob/living/simple_animal/hostile/rogue/orc/spear,
/turf/open/floor/rogue/blocks/stonered,
/area/rogue/under/town/caverogue)
"T" = (
/mob/living/simple_animal/hostile/retaliate/rogue/bigrat,
/obj/effect/landmark/chest_or_mimic,
/turf/open/floor/rogue/blocks/stonered/tiny,
/area/rogue/under/town/caverogue)
"U" = (
/mob/living/simple_animal/hostile/rogue/orc/orc_marauder/spear,
/turf/open/floor/rogue/blocks/stonered,
/area/rogue/under/town/caverogue)
"V" = (
/obj/machinery/light/rogue/torchholder/r,
/obj/structure/toilet,
/turf/open/floor/rogue/blocks/stonered,
/area/rogue/under/town/caverogue)
"W" = (
/obj/structure/giantfur/small,
/turf/open/floor/rogue/blocks/stonered,
/area/rogue/under/town/caverogue)
"X" = (
/mob/living/simple_animal/hostile/retaliate/rogue/minotaur/axe,
/turf/open/floor/rogue/blocks/stonered,
/area/rogue/under/town/caverogue)
"Y" = (
/mob/living/carbon/human/species/zizombie/npc/GRENZEL,
/turf/open/floor/rogue/blocks/stonered/tiny,
/area/rogue/under/town/caverogue)
"Z" = (
/mob/living/simple_animal/hostile/retaliate/rogue/bigrat,
/obj/effect/landmark/chest_or_mimic,
/obj/item/roguecoin/copper/pile,
/turf/open/floor/rogue/blocks/stonered/tiny,
/area/rogue/under/town/caverogue)

(1,1,1) = {"
N
N
N
N
N
N
N
N
N
N
N
N
N
N
N
N
N
N
N
N
N
N
N
N
N
N
N
N
N
N
N
N
N
N
N
N
N
N
N
N
N
N
N
N
N
N
N
N
N
N
"}
(2,1,1) = {"
N
a
a
a
P
G
a
a
a
P
a
P
P
P
P
P
P
P
P
a
a
P
P
P
P
P
a
P
P
P
P
P
P
P
P
P
P
P
P
P
P
P
P
P
P
P
P
P
P
N
"}
(3,1,1) = {"
N
a
P
a
P
P
P
P
a
P
a
a
a
a
a
a
a
a
P
a
P
P
a
a
a
P
a
a
a
a
a
a
a
P
a
a
a
a
a
a
a
a
a
a
a
a
a
Y
P
N
"}
(4,1,1) = {"
N
a
P
a
m
P
m
P
a
P
a
P
P
P
P
P
P
a
P
a
P
a
a
P
a
P
a
a
P
P
P
P
a
P
a
P
a
P
P
P
P
a
P
P
P
a
P
P
P
N
"}
(5,1,1) = {"
N
a
P
P
m
m
m
P
a
P
a
P
a
T
P
a
a
a
P
a
P
a
P
P
a
P
a
P
P
a
a
a
a
P
a
P
a
a
a
n
P
a
P
a
P
P
P
P
a
N
"}
(6,1,1) = {"
N
a
P
P
P
m
v
P
a
P
a
P
a
P
P
a
P
P
P
a
P
a
P
P
a
P
a
P
P
a
P
P
P
P
a
P
P
P
P
P
P
a
a
a
a
O
P
a
a
N
"}
(7,1,1) = {"
N
a
P
e
P
P
m
m
a
a
a
P
a
P
a
a
a
a
a
a
P
a
P
a
a
a
a
a
P
a
P
a
a
a
a
P
a
a
a
a
a
a
P
a
P
P
P
a
P
N
"}
(8,1,1) = {"
N
a
P
a
a
P
P
m
P
P
a
P
a
P
a
P
a
P
a
P
P
a
P
P
P
P
P
P
P
a
P
a
P
a
P
P
P
a
P
P
a
P
P
P
P
a
a
n
P
N
"}
(9,1,1) = {"
N
a
P
a
P
P
P
P
P
P
a
P
a
P
a
P
n
P
a
P
a
a
P
a
a
a
a
a
a
k
P
a
P
a
P
a
a
a
P
a
a
P
a
a
a
a
P
a
a
N
"}
(10,1,1) = {"
N
a
P
a
a
a
P
a
P
a
a
P
a
P
a
P
a
P
a
P
a
P
P
a
P
P
P
a
P
a
a
a
P
a
P
a
P
P
P
a
P
P
P
P
P
a
P
P
P
N
"}
(11,1,1) = {"
N
a
P
a
P
a
a
a
P
P
a
a
a
P
a
P
a
P
a
P
n
P
a
a
P
K
P
P
P
P
P
P
P
a
P
a
P
a
a
a
P
a
P
a
P
a
P
O
a
N
"}
(12,1,1) = {"
N
a
P
P
P
P
n
a
a
P
P
P
a
P
a
a
a
P
a
P
a
P
a
P
P
a
P
a
P
P
a
P
a
a
P
a
P
P
P
a
P
a
a
a
a
a
P
P
a
N
"}
(13,1,1) = {"
N
a
P
a
P
P
P
a
P
P
a
P
a
P
a
P
P
P
P
P
a
P
a
P
a
a
P
n
P
a
a
P
P
a
a
a
a
i
P
a
P
a
P
a
P
a
P
P
a
N
"}
(14,1,1) = {"
N
a
P
a
a
a
P
a
a
a
a
P
P
P
a
a
a
a
a
a
a
P
a
P
a
P
P
a
P
P
a
a
P
a
P
a
P
P
P
a
P
a
P
n
P
a
P
P
a
N
"}
(15,1,1) = {"
N
a
P
a
P
a
P
a
P
a
a
P
a
P
a
P
P
a
P
a
P
P
a
a
a
a
a
a
a
a
a
a
P
a
P
a
P
P
a
a
P
a
P
a
P
a
P
a
a
N
"}
(16,1,1) = {"
N
a
P
a
P
a
a
a
P
P
a
a
a
P
P
P
P
a
P
a
P
a
a
P
P
P
P
P
P
a
P
P
P
a
P
P
P
a
a
P
P
a
P
a
P
a
P
a
a
N
"}
(17,1,1) = {"
N
a
P
a
P
a
P
P
P
a
a
a
P
P
P
P
P
a
P
a
P
P
a
P
O
a
a
a
P
a
a
a
P
a
a
P
P
a
P
P
P
a
P
a
P
a
P
P
a
N
"}
(18,1,1) = {"
N
a
P
a
P
a
P
n
P
a
P
a
a
a
P
P
n
a
P
a
P
a
a
P
P
a
P
a
P
P
a
P
P
a
P
P
b
a
P
K
P
a
P
a
P
a
P
a
n
N
"}
(19,1,1) = {"
N
a
P
a
P
a
P
a
P
a
P
a
P
a
P
P
P
P
P
a
P
P
a
a
P
P
P
a
P
a
a
P
Z
a
P
a
a
P
P
a
P
a
P
a
P
a
P
P
a
N
"}
(20,1,1) = {"
N
a
P
a
P
O
P
a
a
a
P
a
P
a
P
a
P
P
P
a
a
P
P
a
a
n
P
a
a
a
P
P
P
P
P
a
P
P
P
a
P
a
P
a
P
a
a
a
a
N
"}
(21,1,1) = {"
N
a
P
a
P
P
P
P
P
P
P
a
P
a
P
a
a
P
P
P
a
a
P
P
P
P
P
a
a
P
P
a
P
a
a
a
a
a
P
a
P
a
P
a
P
P
P
P
P
N
"}
(22,1,1) = {"
N
a
P
a
P
A
a
a
a
a
a
a
P
a
P
a
a
a
P
P
P
a
a
a
a
a
a
a
P
P
P
a
a
a
P
P
P
a
P
a
P
a
P
a
P
a
P
a
P
N
"}
(23,1,1) = {"
N
a
P
a
P
P
P
P
P
P
P
P
P
a
P
a
P
a
a
P
P
P
P
P
P
P
P
P
P
H
a
a
P
a
a
P
a
a
a
a
P
a
P
a
P
a
a
n
P
N
"}
(24,1,1) = {"
N
a
P
a
a
a
a
a
a
a
a
P
a
a
P
a
P
P
a
a
P
I
l
j
D
w
l
R
P
P
a
P
P
P
a
P
a
P
P
P
P
a
P
a
P
a
P
g
P
N
"}
(25,1,1) = {"
N
a
P
P
P
P
P
P
P
P
a
P
r
P
P
a
a
P
P
a
P
l
P
l
l
l
P
d
P
a
a
a
a
P
a
P
a
P
a
a
P
a
P
a
P
a
P
P
P
N
"}
(26,1,1) = {"
N
a
P
a
a
a
a
a
a
a
a
P
a
P
P
P
a
a
P
a
P
l
R
l
l
l
R
W
P
a
P
P
P
P
P
P
a
P
a
P
P
a
P
a
P
a
m
m
P
N
"}
(27,1,1) = {"
N
a
P
a
P
P
P
P
P
P
P
P
a
a
a
P
P
a
P
a
y
l
l
l
l
X
l
J
P
a
a
a
a
a
a
P
a
P
a
a
P
a
P
a
P
a
P
m
v
N
"}
(28,1,1) = {"
N
a
P
a
a
a
a
a
a
a
a
P
P
a
P
P
a
a
P
a
P
l
B
l
l
l
B
l
P
P
P
P
P
P
a
P
a
a
a
P
P
a
P
a
P
a
P
P
m
N
"}
(29,1,1) = {"
N
a
P
P
P
P
P
a
P
P
a
P
P
a
a
a
a
P
P
a
P
l
P
l
l
l
P
l
P
a
a
a
a
a
n
P
P
P
P
P
P
a
P
a
P
a
P
m
m
N
"}
(30,1,1) = {"
N
a
P
n
a
a
a
a
P
a
a
P
P
P
P
P
P
P
a
a
P
B
o
l
C
c
l
V
P
a
a
P
P
P
P
P
a
a
a
a
P
a
P
a
P
a
P
a
P
N
"}
(31,1,1) = {"
N
a
P
P
P
P
P
P
P
a
P
P
a
P
P
K
P
a
a
P
P
P
P
P
P
P
P
P
P
P
a
a
a
a
a
a
a
P
P
a
P
a
P
a
P
a
P
a
a
N
"}
(32,1,1) = {"
N
a
P
a
a
a
a
a
P
a
P
a
a
a
P
n
a
a
P
P
P
a
P
a
P
a
a
a
P
P
P
P
P
P
P
P
P
P
a
a
P
a
P
a
P
a
P
P
a
N
"}
(33,1,1) = {"
N
a
P
f
P
P
P
a
P
a
P
a
P
a
P
a
a
P
P
P
a
a
a
a
a
a
P
a
H
P
P
a
a
a
a
a
a
a
a
P
P
a
P
a
P
a
P
a
a
N
"}
(34,1,1) = {"
N
a
P
P
P
P
P
a
P
a
a
a
P
a
P
A
P
P
P
P
P
m
P
P
P
a
P
a
P
P
P
P
P
a
P
P
a
P
P
P
a
a
P
a
P
a
P
a
P
N
"}
(35,1,1) = {"
N
a
P
a
a
a
a
a
P
P
P
P
P
a
P
P
P
P
m
m
m
m
P
a
P
a
P
n
a
a
a
P
P
P
P
a
a
P
a
a
a
P
P
a
a
a
P
a
a
N
"}
(36,1,1) = {"
N
a
P
a
P
a
P
a
a
a
a
P
a
a
P
P
P
P
m
P
P
m
P
a
P
a
P
P
P
P
a
a
P
P
P
P
a
P
a
P
P
P
P
P
P
P
P
P
a
N
"}
(37,1,1) = {"
N
a
P
a
P
n
P
P
a
P
a
a
a
P
P
P
a
m
a
a
a
F
P
a
a
a
a
a
a
a
a
a
a
P
P
P
a
a
a
a
a
P
a
a
a
a
a
a
a
N
"}
(38,1,1) = {"
N
a
P
a
P
P
P
P
a
P
a
P
a
P
P
a
a
P
P
P
P
P
P
P
P
P
P
P
P
P
P
P
a
a
P
P
P
P
P
P
P
P
a
P
P
a
P
P
P
N
"}
(39,1,1) = {"
N
a
P
a
a
a
P
a
a
P
a
P
P
P
a
a
P
P
E
a
P
a
a
a
a
a
a
a
a
a
a
a
a
a
a
P
P
a
a
a
a
a
a
P
a
a
a
a
O
N
"}
(40,1,1) = {"
N
a
P
P
P
a
P
P
P
P
P
P
P
a
a
P
P
P
P
a
P
a
P
P
P
P
P
P
P
P
P
P
a
P
a
a
P
P
P
a
P
P
a
P
P
P
P
P
P
N
"}
(41,1,1) = {"
N
a
a
P
a
a
a
a
P
O
a
a
a
a
P
P
a
n
P
a
P
P
P
P
P
P
P
P
P
P
P
P
P
P
P
a
a
a
P
a
P
a
a
a
a
a
a
P
a
N
"}
(42,1,1) = {"
N
P
a
P
P
P
P
a
P
P
P
a
a
a
P
O
a
P
P
a
P
a
y
a
a
a
a
a
a
a
a
P
P
P
P
P
P
a
P
P
P
a
P
a
P
P
a
a
a
N
"}
(43,1,1) = {"
N
h
a
P
P
a
a
a
P
P
a
a
P
a
P
P
a
P
a
a
P
a
P
a
q
l
l
l
l
q
p
P
a
a
a
P
a
a
a
P
P
O
P
a
P
P
P
P
a
N
"}
(44,1,1) = {"
N
a
P
P
a
a
P
P
P
P
a
P
P
a
P
P
a
P
a
P
P
a
P
a
l
l
l
l
U
l
u
P
a
P
a
a
a
P
a
a
P
P
P
a
a
a
P
a
a
N
"}
(45,1,1) = {"
N
a
P
a
a
P
P
a
n
P
a
n
P
a
P
P
a
P
a
a
a
a
P
a
l
l
l
t
l
M
Q
P
n
P
a
P
P
P
P
a
a
P
P
a
P
n
P
P
a
N
"}
(46,1,1) = {"
N
a
a
a
P
P
P
P
a
P
P
P
P
a
P
P
a
P
a
P
P
a
P
a
l
l
l
l
S
l
z
P
a
P
a
a
a
a
P
a
P
P
P
P
P
a
a
P
a
N
"}
(47,1,1) = {"
N
a
P
P
P
P
a
a
a
P
a
a
a
n
a
a
a
P
a
P
P
P
P
a
q
l
l
l
l
q
x
P
a
P
a
P
P
a
P
a
a
a
a
a
P
P
a
P
a
N
"}
(48,1,1) = {"
N
a
P
O
a
P
P
a
P
P
P
P
P
P
P
P
a
P
a
P
P
a
y
a
a
a
a
a
a
a
a
P
a
P
a
P
P
a
P
a
P
P
P
a
P
a
a
a
n
N
"}
(49,1,1) = {"
N
P
P
P
a
a
a
a
a
a
a
a
a
a
a
a
a
a
a
P
P
a
P
P
P
P
P
P
P
P
P
P
a
a
a
a
n
a
P
a
P
P
P
n
a
a
P
P
a
N
"}
(50,1,1) = {"
N
N
N
N
N
N
N
N
N
N
N
N
N
N
N
N
N
N
N
N
N
a
N
N
N
N
N
N
N
N
N
N
N
N
N
N
N
N
N
N
N
N
N
N
N
N
N
N
N
N
"}
